1133111111
1        2
3111     1
3        1
3   1    3
1   1    3
1   1    2
3       11
3        1
3121311311